   /|\       /|\       /|\       /|\       /|\     #   #     ╦ ╫ ' *   
  */|*\     //|*\     //|\\     /*|\\     //|\\    #   #    *' ╦*╦╩╦╥  
 ///|\\\   ///|\\\   ///|\\\   ///|\\\   ///|\\\   #   #    ╦╩╦╝╫' '╫  
////|\\\\ //*/|\\\\ ////|\*\\ ////|\\\\ ////|\\\\  #   #    '╨' ╦╦ *   
---|-|--- ---|-|--- ---|-|--- ---|-|--- ---|-|---  #   #     ╬* '╬═╬   
   |-|       |-|       |-|       |-|       |-|     #   #      ╫╣╫╠*    
   |-|       |-|       |-|       |-|       |-|     #   #       |-|     
   /|\       /|\       /|\       /|\        #######    ##      |-|     
  //|\\     //|\\     //|\\     */|\\      #             #     |-|     
 ///|\\\   //*|\\\   ///|\\\   ///|*\\    #               #    |-|     
////|\\\\ ////|\*\\ ////|\\\\ ////|\\\\  #      ####       #           
---|-|--- ---|-|--- ---|-|--- ---|-|--- #      #    #       ###########
   |-|       |-|       |-|       |-|   #      #      #                 
   |-|       |-|       |-|       |-|  #      #        ##              ▲
######################################      #           #              
                                           #     ▓▓      ##############
▲X                                        #      ▓▓                    
                                         #      ▓▓▓▓▓                  
#########################################                              
   /|\       /|\       /|\       /|\       /|\       /|\       /|\     
  //|\*     //|\\     //|\\     /*|\\     //|\\     //|\\     //|\\    
 //*|\\\   /*/|\\\   ///|\\\   ///|\*\   ///|\\\   ///|\*\   ///|\\\   
////|\\\\ ////|\\\* ////|\\\\ ////|\\\\ ////|\\\\ /*//|\\\\ ////|\\\\  
---|-|--- ---|-|--- ---|-|--- ---|-|--- ---|-|--- ---|-|--- ---|-|---  
   |-|       |-|       |-|       |-|       |-|       |-|       |-|     
   |-|       |-|       |-|       |-|       |-|       |-|       |-|     