###############################################################################################################################################################################################
#                                                                                                                                                                                             #
# ▲X                                                                                                                                                                                          #
#                                                                                                                                                                                             #
##################################=======########################################################################         ##################################            #######################
#       #               #        #       #      #             #            #      #                       #\\\\\#         #\\\\\#                          #            #                     #
#       #               #        #   ◊   #      #             #########    #      #                       #\\\\\#         #\\\\\#                          #            #                     #
#       #               #        #       #           #        #            #      #       ########        #\\\\\#         #\\\\\#         #                #            #                     #
#            #####################       #           #                     #              #      #        #\\\\\#         #\\\\\#         #                #            #                     #
#            #\\\\\\\\\\\\\\\\\\\#       #           #                     #              #      #        #\\\\\#         #\\\\\#         #                #            #######################
#######      #\\\\\\\\\\\\\\\\\\\#       #           #########################       ######      #        #\\\\\#         #\\\\\#         #                #                                  #
#            #\\\\\\\\\\\\\\\\\\\#       #           #                     #              #      #        #\\\\\#         #\\\\\#         ##########       #                                  #
#            #\\\\\\\\\\\\\\\\\\\#       #######     #                                    #      #        #\\\\\#         #\\\\\#         #        #       #                                  #
#            #####################       #           #               #                    #      #        #\\\\\#         #\\\\\#         #        #       #                                  #
#                   #                    #           #######         ######################      ################         #\\\\\#         #        #       #            #############         #
#                   #                    #                                                                                #\\\\\#                  #       #            #           #         #
#                   #                    #                                                                                #\\\\\#                  #       #            #           #         #
#############       #           #################################################################################         #\\\\\#       ############       #            #           #         #
#                   #           #                                 #        #                      #             #         #\\\\\#       #                  #            #           #         #
#                   #           #                                 #        #                      #             #         #\\\\\#       #                  #            #           #         #
#       #        ####           #       #       #                 #                 #######       #      ########         #\\\\\#       #                  #            #           #         #
#       #                       #       #       #########         #                 #     #       #             #         #\\\\\#       ####################            #           #         #
#       #                       #       #########       #         ##########      ###     #       #             #         #\\\\\#                                       #           #         #
#       #                       #               #       #         #        #        #     #########        ######         #\\\\\#                                       #           #         #
#       #                       ######                  #         #        #        #                                     #\\\\\#                                       #           #         #
#####################           #                       #         #        #        #                                     #\\\\\#                                       #           #         #
#          #        #           ##################      ####      #                 #         ###########################################################       ##############      #         #
#                   #                            #         #      #                              #        #                                             #                           #         #
#                   #                            #         #      #       ######                 #        #                                             #                           #         #
############        #                            #     ######     #            #          ########                 #           #                        #                           #         #
#                   #                            #     #          #            #                 #                 #           ##################       #############################         #
#                   #           #########        #     #          ####################           ###################           #        #               #                                     #
#       #############           #\\\\\\\#        #     #     ######               #                 #                          #        #               #                                     #
#          #        #           #########        #######          #               #                 #                          #        #               #                                     #
#          #                    #                                 #                                 #     ######################        ##############################           ##############
#          #                    #           #                     ############                 ######     #        #                    #                            #           #            #
#      #####        #           #           #        ##############          ############      #          #        #                    #                 #          #           #            #
#          #        #           #        ######      #                       #                            #        #         ############       ###########          #           #     #      #
#                   #           #           #        #                                                                                                    #          #           #     #      #
#                   #           #           #        #          #                                                                                         #          #           #     #      #
#######        #######################################################################################################################################################     #     #######      #
#     #                                                   #                 #       #                                                                #                     #           #      #
#     #                                                   #                 #                                   #             ########################                     #           #      #
#     #         #         ################     ##         #                 #                                   #             #                                            #           #      #
#     #         #         #       #             #####     ###################       #####       #################             #                                            #           #      #
#     #         #         #       #             #         #                         #                           #                        #           #######################           #      #
#     #####################                     #         #                         #                           ##                       #           #                                 #      #
#                                       #########      ####       ###########################################################################        #                                 #      #
#                                       #\\\\\\\#         #             #                       #                                        #           #          #                      #      #
#                                       #\\\\\\\#         #             #                       #                                        #           ###        ########################      #
#############         #########################################         #       ####      #######       #####       ######################           #          #                             #
#                                                                       #       #                       #                                            #                                        #
#                                                                       #       #                       #                                            #                                        #
###############################################################################################################################################################################################