|------------------------------------------------|
|                                                |
|       ▲                           ▲            |
|                                                |
|                                                |
|                                                |
|                                                |
|                                                |
|                                                |
|                                                |
|                                                |
|▲X                                              |
|                                                |
|                                         ▲      |
|                                                |
|                                                |
|                                                |
|                                                |
|                                                |
|                                                |
|                                                |
|                                                |
|------------------------------------------------|