|-||-||-||-||-||-||-||-||-||-||-||-||-|
|-||-||-||-||-||-||-||-||-||-||-||-||-|
|-||-||-||-||-||-||-||-||-||-||-||-||-|
|-||-||-||-||-||-||-||-||-||-||-||-||-|
|-||-||-||-||-||-||-||-||-||-||-||-||-|
|-||-||-||-||-||-||-||-||-||-||-||-||-|
|-||-||-||-||-||-||-||-||-||-||-||-||-|
|-||-||-||-||-||-||-||-||-||-||-||-||-|
|-||-||-||-||-||-||-||-||-||-||-||-||-|
|-||-||-||-||-||-||-||-||-||-||-||-||-|
#######################################
                                       
▲X                                    ▲
                                       
#######################################
───────────────────────────────────────
~~~~~~~~~~~~~~~~~~~~~~~~~~~~~~~~~~~~~~~
~~~~~~~~~~~~~~~~~~~~~~~~~~~~~~~~~~~~~~~
~~~~~~~~~~~~~~~~~~~~~~~~~~~~~~~~~~~~~~~
───────────────────────────────────────